0x12787F68, 37377930296023760, 168906431, 168906492, 61, 640x360 
0x12787F68, 37377930298687792, 168906699, 168906706, 7, 640x360 
0x12787F68, 37377930300017032, 168906831, 168906834, 3, 640x360 
0x12787F68, 37377930301345192, 168906967, 168906969, 2, 640x360 
0x12787F68, 37377930302676648, 168907105, 168907114, 9, 640x360 
0x12787F68, 37377930304013328, 168907218, 168907220, 2, 640x360 
0x12787F68, 37377930305339808, 168907351, 168907353, 2, 640x360 
0x12787F68, 37377930306671536, 168907477, 168907479, 2, 640x360 
0x12787F68, 37377930308001584, 168907621, 168907624, 3, 640x360 
0x12787F68, 37377930309322776, 168907746, 168907748, 2, 640x360 
0x12787F68, 37377930315999976, 168908429, 168908462, 33, 1920x1080 
0x12787F68, 37377930321336016, 168908966, 168908975, 9, 1920x1080 
0x12787F68, 37377930326673352, 168909485, 168909495, 10, 1920x1080 
0x12787F68, 37377930332015600, 168910027, 168910037, 10, 1920x1080 
0x12787F68, 37377930337357032, 168910557, 168910567, 10, 1920x1080 
0x12787F68, 37377930342690936, 168911094, 168911104, 10, 1920x1080 
0x12787F68, 37377930348029840, 168911629, 168911636, 7, 1920x1080 
0x12787F68, 37377930353369016, 168912162, 168912171, 9, 1920x1080 
0x12787F68, 37377930358703080, 168912701, 168912711, 10, 1920x1080 
0x12787F68, 37377930364042872, 168913220, 168913230, 10, 1920x1080 
0x12787F68, 37377930369386576, 168913767, 168913777, 10, 1920x1080 
0x12787F68, 37377930374725376, 168914275, 168914292, 17, 1920x1080 
0x12787F68, 37377930380066952, 168914814, 168914824, 10, 1920x1080 
0x12787F68, 37377930385410080, 168915344, 168915355, 11, 1920x1080 
0x12787F68, 37377930390757608, 168915893, 168915904, 11, 1920x1080 
0x12787F68, 37377930396092728, 168916420, 168916431, 11, 1920x1080 
0x12787F68, 37377930401432968, 168916949, 168916960, 11, 1920x1080 
0x12787F68, 37377930406771896, 168917479, 168917491, 12, 1920x1080 
0x12787F68, 37377930412111672, 168918039, 168918048, 9, 1920x1080 
0x12787F68, 37377930417457736, 168918545, 168918554, 9, 1920x1080 
0x12787F68, 37377930422792168, 168919088, 168919101, 13, 1920x1080 
0x12787F68, 37377930428125944, 168919621, 168919635, 14, 1920x1080 
0x12787F68, 37377930433468456, 168920182, 168920192, 10, 1920x1080 
0x12787F68, 37377930438804400, 168920680, 168920694, 14, 1920x1080 
0x12787F68, 37377930444138808, 168921220, 168921230, 10, 1920x1080 
0x12787F68, 37377930449485824, 168921772, 168921786, 14, 1920x1080 
0x12787F68, 37377930454833688, 168922290, 168922300, 10, 1920x1080 
0x12787F68, 37377930460173656, 168922836, 168922845, 9, 1920x1080 
0x12787F68, 37377930465514952, 168923358, 168923368, 10, 1920x1080 
0x12787F68, 37377930470853976, 168923894, 168923903, 9, 1920x1080 
0x12787F68, 37377930476195768, 168924418, 168924434, 16, 1920x1080 
0x12787F68, 37377930481526512, 168924954, 168924966, 12, 1920x1080 
0x12787F68, 37377930486860880, 168925497, 168925508, 11, 1920x1080 
0x12787F68, 37377930492204760, 168926036, 168926047, 11, 1920x1080 
0x12787F68, 37377930497551016, 168926583, 168926594, 11, 1920x1080 
0x12787F68, 37377930502893576, 168927108, 168927118, 10, 1920x1080 
0x12787F68, 37377930508233912, 168927621, 168927633, 12, 1920x1080 
0x12787F68, 37377930513573304, 168928166, 168928195, 29, 1920x1080 
0x12787F68, 37377930518915712, 168928700, 168928713, 13, 1920x1080 
0x12787F68, 37377930524252856, 168929238, 168929248, 10, 1920x1080 
0x12787F68, 37377930529594200, 168929783, 168929793, 10, 1920x1080 
0x12787F68, 37377930534934304, 168930292, 168930301, 9, 1920x1080 
0x12787F68, 37377930540272744, 168930849, 168930859, 10, 1920x1080 
0x12787F68, 37377930545612496, 168931366, 168931405, 39, 1920x1080 
0x12787F68, 37377930550950984, 168931914, 168931932, 18, 1920x1080 
0x12787F68, 37377930556295400, 168932427, 168932436, 9, 1920x1080 
0x12787F68, 37377930561630432, 168932959, 168932970, 11, 1920x1080 
0x12787F68, 37377930566969008, 168933527, 168933539, 12, 1920x1080 
0x12787F68, 37377930572304000, 168934060, 168934073, 13, 1920x1080 
0x12787F68, 37377930577640280, 168934579, 168934592, 13, 1920x1080 
0x12787F68, 37377930582981944, 168935118, 168935128, 10, 1920x1080 
0x12787F68, 37377930588318080, 168935664, 168935673, 9, 1920x1080 
0x12787F68, 37377930593662936, 168936200, 168936210, 10, 1920x1080 
0x12787F68, 37377930598999280, 168936713, 168936723, 10, 1920x1080 
0x12787F68, 37377930604344616, 168937246, 168937260, 14, 1920x1080 
0x12787F68, 37377930609686112, 168937770, 168937784, 14, 1920x1080 
0x12787F68, 37377930615030704, 168938296, 168938306, 10, 1920x1080 
0x12787F68, 37377930620379144, 168938874, 168938883, 9, 1920x1080 
0x12787F68, 37377930625718880, 168939390, 168939400, 10, 1920x1080 
0x12787F68, 37377930631054056, 168939903, 168939915, 12, 1920x1080 
0x12787F68, 37377930636390640, 168940439, 168940450, 11, 1920x1080 
0x12787F68, 37377930641736272, 168940973, 168940982, 9, 1920x1080 
0x12787F68, 37377930647076752, 168941538, 168941549, 11, 1920x1080 
0x12787F68, 37377930652419392, 168942038, 168942048, 10, 1920x1080 
0x12787F68, 37377930657752872, 168942583, 168942594, 11, 1920x1080 
0x12787F68, 37377930663097160, 168943104, 168943114, 10, 1920x1080 
0x12787F68, 37377930668438784, 168943678, 168943689, 11, 1920x1080 
0x12787F68, 37377930673776208, 168944192, 168944201, 9, 1920x1080 
0x12787F68, 37377930679113480, 168944729, 168944739, 10, 1920x1080 
0x12787F68, 37377930684450080, 168945258, 168945268, 10, 1920x1080 
0x12787F68, 37377930689797592, 168945773, 168945782, 9, 1920x1080 
0x12787F68, 37377930695135680, 168946311, 168946323, 12, 1920x1080 
0x12787F68, 37377930700484280, 168946860, 168946871, 11, 1920x1080 
0x12787F68, 37377930705825472, 168947373, 168947383, 10, 1920x1080 
0x12787F68, 37377930711168120, 168947939, 168947947, 8, 1920x1080 
0x12787F68, 37377930716506448, 168948447, 168948455, 8, 1920x1080 
0x12787F68, 37377930721840168, 168948994, 168949004, 10, 1920x1080 
0x12787F68, 37377930727179344, 168949548, 168949559, 11, 1920x1080 
0x12787F68, 37377930732521984, 168950050, 168950059, 9, 1920x1080 
0x12787F68, 37377930737863368, 168950593, 168950604, 11, 1920x1080 
0x12787F68, 37377930743208456, 168951118, 168951129, 11, 1920x1080 
0x12787F68, 37377930748552736, 168951669, 168951680, 11, 1920x1080 
0x12787F68, 37377930753889912, 168952204, 168952215, 11, 1920x1080 
0x12787F68, 37377930759223728, 168952728, 168952738, 10, 1920x1080 
0x12787F68, 37377930764561288, 168953251, 168953265, 14, 1920x1080 
0x12787F68, 37377930769900256, 168953789, 168953799, 10, 1920x1080 
0x12787F68, 37377930775240848, 168954329, 168954339, 10, 1920x1080 
0x12787F68, 37377930780582248, 168954877, 168954887, 10, 1920x1080 
0x12787F68, 37377930785923576, 168955383, 168955393, 10, 1920x1080 
0x12787F68, 37377930791263224, 168955917, 168955928, 11, 1920x1080 
0x12787F68, 37377930796610872, 168956465, 168956474, 9, 1920x1080 
0x12787F68, 37377930801951128, 168957009, 168957019, 10, 1920x1080 
0x12787F68, 37377930807291104, 168957553, 168957563, 10, 1920x1080 
0x12787F68, 37377930812635208, 168958095, 168958105, 10, 1920x1080 
0x12787F68, 37377930817972112, 168958621, 168958632, 11, 1920x1080 
0x12787F68, 37377930823314176, 168959152, 168959163, 11, 1920x1080 
0x12787F68, 37377930828654720, 168959699, 168959708, 9, 1920x1080 
0x12787F68, 37377930833995280, 168960206, 168960217, 11, 1920x1080 
0x12787F68, 37377930839332456, 168960756, 168960765, 9, 1920x1080 
0x12787F68, 37377930844670264, 168961289, 168961299, 10, 1920x1080 
0x12787F68, 37377930850008768, 168961846, 168961856, 10, 1920x1080 
0x12787F68, 37377930855345424, 168962346, 168962354, 8, 1920x1080 
0x12787F68, 37377930860681832, 168962891, 168962900, 9, 1920x1080 
0x12787F68, 37377930866021824, 168963406, 168963415, 9, 1920x1080 
0x12787F68, 37377930871365040, 168963960, 168963970, 10, 1920x1080 
0x12787F68, 37377930876701328, 168964508, 168964517, 9, 1920x1080 
0x12787F68, 37377930882047080, 168965010, 168965020, 10, 1920x1080 
0x12787F68, 37377930887384032, 168965549, 168965558, 9, 1920x1080 
0x12787F68, 37377930892721360, 168966094, 168966103, 9, 1920x1080 
0x12787F68, 37377930898059600, 168966612, 168966621, 9, 1920x1080 
0x12787F68, 37377930903402160, 168967147, 168967159, 12, 1920x1080 
0x12787F68, 37377930908741440, 168967680, 168967693, 13, 1920x1080 
0x12787F68, 37377930914082408, 168968245, 168968255, 10, 1920x1080 
0x12787F68, 37377930919423072, 168968752, 168968761, 9, 1920x1080 
0x12787F68, 37377930924757848, 168969295, 168969304, 9, 1920x1080 
0x12787F68, 37377930930099664, 168969840, 168969849, 9, 1920x1080 
0x12787F68, 37377930935434400, 168970351, 168970359, 8, 1920x1080 
0x12787F68, 37377930940784064, 168970909, 168970919, 10, 1920x1080 
0x12787F68, 37377930946124168, 168971417, 168971426, 9, 1920x1080 
0x12787F68, 37377930951464904, 168971963, 168971972, 9, 1920x1080 
0x12787F68, 37377930956804768, 168972495, 168972506, 11, 1920x1080 
0x12787F68, 37377930962148232, 168973042, 168973051, 9, 1920x1080 
0x12787F68, 37377930967483984, 168973559, 168973569, 10, 1920x1080 
0x12787F68, 37377930972830256, 168974121, 168974133, 12, 1920x1080 
0x12787F68, 37377930978170336, 168974653, 168974663, 10, 1920x1080 
0x12787F68, 37377930983515184, 168975167, 168975177, 10, 1920x1080 
0x12787F68, 37377930988855120, 168975685, 168975696, 11, 1920x1080 
0x12787F68, 37377930994217440, 168976234, 168976244, 10, 1920x1080 
0x12787F68, 37377930999555120, 168976775, 168976785, 10, 1920x1080 
0x12787F68, 37377931004891048, 168977291, 168977301, 10, 1920x1080 
0x12787F68, 37377931010230216, 168977854, 168977864, 10, 1920x1080 
0x12787F68, 37377931015568288, 168978387, 168978400, 13, 1920x1080 
0x12787F68, 37377931020908448, 168978927, 168978937, 10, 1920x1080 
0x12787F68, 37377931026241808, 168979427, 168979437, 10, 1920x1080 
0x12787F68, 37377931031578440, 168979973, 168979985, 12, 1920x1080 
0x12787F68, 37377931036913544, 168980503, 168980515, 12, 1920x1080 
0x12787F68, 37377931042248256, 168981044, 168981056, 12, 1920x1080 
0x12787F68, 37377931047582792, 168981600, 168981610, 10, 1920x1080 
0x12787F68, 37377931052922024, 168982107, 168982117, 10, 1920x1080 
0x12787F68, 37377931058267048, 168982648, 168982677, 29, 1920x1080 
0x12787F68, 37377931063606240, 168983179, 168983191, 12, 1920x1080 
0x12787F68, 37377931068949864, 168983725, 168983736, 11, 1920x1080 
0x12787F68, 37377931074288968, 168984261, 168984273, 12, 1920x1080 
0x12787F68, 37377931079624072, 168984798, 168984808, 10, 1920x1080 
0x12787F68, 37377931084961520, 168985307, 168985322, 15, 1920x1080 
0x12787F68, 37377931090299944, 168985859, 168985869, 10, 1920x1080 
0x12787F68, 37377931095639928, 168986374, 168986384, 10, 1920x1080 
0x12787F68, 37377931100981536, 168986928, 168986938, 10, 1920x1080 
0x12787F68, 37377931106326864, 168987439, 168987451, 12, 1920x1080 
0x12787F68, 37377931111664960, 168987974, 168987984, 10, 1920x1080 
0x12787F68, 37377931117001448, 168988523, 168988534, 11, 1920x1080 
0x12787F68, 37377931122340920, 168989070, 168989080, 10, 1920x1080 
0x12787F68, 37377931127684896, 168989601, 168989612, 11, 1920x1080 
0x12787F68, 37377931133017376, 168990123, 168990133, 10, 1920x1080 
0x12787F68, 37377931138357864, 168990635, 168990648, 13, 1920x1080 
0x12787F68, 37377931143701064, 168991190, 168991200, 10, 1920x1080 
0x12787F68, 37377931149046616, 168991726, 168991736, 10, 1920x1080 
0x12787F68, 37377931154393032, 168992260, 168992269, 9, 1920x1080 
0x12787F68, 37377931159731688, 168992796, 168992806, 10, 1920x1080 
0x12787F68, 37377931165064992, 168993310, 168993319, 9, 1920x1080 
0x12787F68, 37377931170408304, 168993873, 168993883, 10, 1920x1080 
0x12787F68, 37377931175745992, 168994371, 168994381, 10, 1920x1080 
0x12787F68, 37377931181087496, 168994934, 168994944, 10, 1920x1080 
0x12787F68, 37377931186420632, 168995440, 168995450, 10, 1920x1080 
0x12787F68, 37377931191756424, 168995975, 168995987, 12, 1920x1080 
0x12787F68, 37377931197097760, 168996520, 168996531, 11, 1920x1080 
0x12787F68, 37377931202442528, 168997059, 168997068, 9, 1920x1080 
0x12787F68, 37377931207784736, 168997589, 168997599, 10, 1920x1080 
0x12787F68, 37377931213124208, 168998144, 168998154, 10, 1920x1080 
0x12787F68, 37377931218456408, 168998670, 168998679, 9, 1920x1080 
0x12787F68, 37377931223788720, 168999199, 168999209, 10, 1920x1080 
0x12787F68, 37377931229128792, 168999736, 168999746, 10, 1920x1080 
0x12787F68, 37377931234471552, 169000249, 169000271, 22, 1920x1080 
0x12787F68, 37377931239806936, 169000789, 169000880, 91, 1920x1080 
0x12787F68, 37377931245147576, 169001311, 169001322, 11, 1920x1080 
0x12787F68, 37377931250478544, 169001869, 169001879, 10, 1920x1080 
0x12787F68, 37377931255819024, 169002382, 169002390, 8, 1920x1080 
0x12787F68, 37377931261162584, 169002915, 169002928, 13, 1920x1080 
0x12787F68, 37377931266499952, 169003452, 169003470, 18, 1920x1080 
0x12787F68, 37377931271843088, 169003982, 169003994, 12, 1920x1080 
0x12787F68, 37377931277182824, 169004517, 169004526, 9, 1920x1080 
0x12787F68, 37377931282521320, 169005055, 169005067, 12, 1920x1080 
0x12787F68, 37377931287860384, 169005585, 169005594, 9, 1920x1080 
0x12787F68, 37377931293195240, 169006135, 169006155, 20, 1920x1080 
0x12787F68, 37377931298532056, 169006667, 169006681, 14, 1920x1080 
0x12787F68, 37377931303875640, 169007218, 169007228, 10, 1920x1080 
0x12787F68, 37377931309213760, 169007745, 169007754, 9, 1920x1080 
0x12787F68, 37377931314553832, 169008273, 169008281, 8, 1920x1080 
0x12787F68, 37377931319901720, 169008824, 169008835, 11, 1920x1080 
0x12787F68, 37377931325237632, 169009321, 169009356, 35, 1920x1080 
0x12787F68, 37377931330585520, 169009876, 169009887, 11, 1920x1080 
0x12787F68, 37377931335927440, 169010403, 169010413, 10, 1920x1080 
0x12787F68, 37377931341272808, 169010945, 169010956, 11, 1920x1080 
0x12787F68, 37377931346611600, 169011485, 169011494, 9, 1920x1080 
0x12787F68, 37377931351948480, 169011995, 169012012, 17, 1920x1080 
0x12787F68, 37377931357289776, 169012532, 169012551, 19, 1920x1080 
0x12787F68, 37377931362632544, 169013065, 169013080, 15, 1920x1080 
0x12787F68, 37377931367978160, 169013609, 169013622, 13, 1920x1080 
0x12787F68, 37377931373315640, 169014149, 169014158, 9, 1920x1080 
0x12787F68, 37377931378659544, 169014663, 169014676, 13, 1920x1080 
0x12787F68, 37377931384001688, 169015208, 169015216, 8, 1920x1080 
0x12787F68, 37377931389341248, 169015754, 169015764, 10, 1920x1080 
0x12787F68, 37377931394681416, 169016267, 169016276, 9, 1920x1080 
0x12787F68, 37377931400024872, 169016824, 169016840, 16, 1920x1080 
0x12787F68, 37377931405368616, 169017350, 169017381, 31, 1920x1080 
0x12787F68, 37377931410702808, 169017878, 169017888, 10, 1920x1080 
0x12787F68, 37377931416042200, 169018403, 169018413, 10, 1920x1080 
0x12787F68, 37377931421387512, 169018956, 169018966, 10, 1920x1080 
0x12787F68, 37377931426724680, 169019470, 169019480, 10, 1920x1080 
0x12787F68, 37377931432067112, 169020006, 169020015, 9, 1920x1080 
0x12787F68, 37377931437415792, 169020547, 169020556, 9, 1920x1080 
0x12787F68, 37377931442755464, 169021096, 169021106, 10, 1920x1080 
0x12787F68, 37377931448094696, 169021614, 169021623, 9, 1920x1080 
0x12787F68, 37377931453436088, 169022151, 169022162, 11, 1920x1080 
0x12787F68, 37377931458777024, 169022681, 169022691, 10, 1920x1080 
0x12787F68, 37377931464116168, 169023244, 169023254, 10, 1920x1080 
0x12787F68, 37377931469462712, 169023751, 169023761, 10, 1920x1080 
0x12787F68, 37377931474802048, 169024290, 169024300, 10, 1920x1080 
0x12787F68, 37377931480145912, 169024829, 169024838, 9, 1920x1080 
0x12787F68, 37377931485486040, 169025375, 169025385, 10, 1920x1080 
0x12787F68, 37377931490828496, 169025884, 169025893, 9, 1920x1080 
0x12787F68, 37377931496174376, 169026428, 169026439, 11, 1920x1080 
0x12787F68, 37377931501516848, 169026976, 169026989, 13, 1920x1080 
0x12787F68, 37377931506854816, 169027486, 169027497, 11, 1920x1080 
0x12787F68, 37377931512191192, 169028041, 169028050, 9, 1920x1080 
0x12787F68, 37377931517533680, 169028577, 169028586, 9, 1920x1080 
0x12787F68, 37377931522869096, 169029119, 169029127, 8, 1920x1080 
0x12787F68, 37377931528208992, 169029624, 169029634, 10, 1920x1080 
0x12787F68, 37377931533554216, 169030163, 169030171, 8, 1920x1080 
0x12787F68, 37377931538888240, 169030689, 169030698, 9, 1920x1080 
0x12787F68, 37377931544226352, 169031253, 169031263, 10, 1920x1080 
0x12787F68, 37377931549562160, 169031788, 169031798, 10, 1920x1080 
0x12787F68, 37377931554905640, 169032296, 169032304, 8, 1920x1080 
0x12787F68, 37377931560242432, 169032861, 169032871, 10, 1920x1080 
0x12787F68, 37377931565584448, 169033362, 169033373, 11, 1920x1080 
0x12787F68, 37377931570921184, 169033919, 169033929, 10, 1920x1080 
0x12787F68, 37377931576262280, 169034446, 169034456, 10, 1920x1080 
0x12787F68, 37377931581603832, 169034965, 169034973, 8, 1920x1080 
0x12787F68, 37377931586952824, 169035514, 169035523, 9, 1920x1080 
0x12787F68, 37377931592285792, 169036043, 169036053, 10, 1920x1080 
0x12787F68, 37377931597621336, 169036588, 169036596, 8, 1920x1080 
0x12787F68, 37377931602963520, 169037112, 169037122, 10, 1920x1080 
0x12787F68, 37377931608307408, 169037636, 169037650, 14, 1920x1080 
0x12787F68, 37377931613651480, 169038199, 169038209, 10, 1920x1080 
0x12787F68, 37377931618993640, 169038720, 169038731, 11, 1920x1080 
0x12787F68, 37377931624331264, 169039260, 169039271, 11, 1920x1080 
0x12787F68, 37377931629671656, 169039801, 169039811, 10, 1920x1080 
0x12787F68, 37377931635008224, 169040308, 169040318, 10, 1920x1080 
0x12787F68, 37377931640347144, 169040852, 169040863, 11, 1920x1080 
0x12787F68, 37377931645686096, 169041378, 169041388, 10, 1920x1080 
0x12787F68, 37377931651030368, 169041903, 169041913, 10, 1920x1080 
0x12787F68, 37377931656369312, 169042472, 169042484, 12, 1920x1080 
0x12787F68, 37377931661706576, 169042991, 169043000, 9, 1920x1080 
0x12787F68, 37377931667044592, 169043522, 169043533, 11, 1920x1080 
0x12787F68, 37377931672387504, 169044061, 169044071, 10, 1920x1080 
0x12787F68, 37377931677726272, 169044604, 169044613, 9, 1920x1080 
0x12787F68, 37377931683066464, 169045117, 169045164, 47, 1920x1080 
0x12787F68, 37377931688404408, 169045662, 169045677, 15, 1920x1080 
0x12787F68, 37377931693746408, 169046179, 169046188, 9, 1920x1080 
0x12787F68, 37377931699088312, 169046741, 169046751, 10, 1920x1080 
0x12787F68, 37377931704434480, 169047247, 169047257, 10, 1920x1080 
0x12787F68, 37377931709768408, 169047788, 169047798, 10, 1920x1080 
0x12787F68, 37377931715108288, 169048321, 169048344, 23, 1920x1080 
0x12787F68, 37377931720446424, 169048846, 169048857, 11, 1920x1080 
0x12787F68, 37377931725788640, 169049390, 169049400, 10, 1920x1080 
0x12787F68, 37377931731123496, 169049929, 169049939, 10, 1920x1080 
0x12787F68, 37377931736466000, 169050446, 169050456, 10, 1920x1080 
0x12787F68, 37377931741798152, 169050984, 169050994, 10, 1920x1080 
0x12787F68, 37377931747146224, 169051516, 169051535, 19, 1920x1080 
0x12787F68, 37377931752488184, 169052052, 169052063, 11, 1920x1080 
0x12787F68, 37377931757831008, 169052585, 169052597, 12, 1920x1080 
0x12787F68, 37377931763162256, 169053133, 169053143, 10, 1920x1080 
0x12787F68, 37377931768498648, 169053682, 169053692, 10, 1920x1080 
0x12787F68, 37377931773843776, 169054198, 169054208, 10, 1920x1080 
0x12787F68, 37377931779183600, 169054750, 169054760, 10, 1920x1080 
0x12787F68, 37377931784525776, 169055259, 169055269, 10, 1920x1080 
0x12787F68, 37377931789858400, 169055813, 169055822, 9, 1920x1080 
0x12787F68, 37377931795201848, 169056322, 169056335, 13, 1920x1080 
0x12787F68, 37377931800540744, 169056886, 169056896, 10, 1920x1080 
0x12787F68, 37377931805881776, 169057396, 169057405, 9, 1920x1080 
0x12787F68, 37377931811225264, 169057948, 169057957, 9, 1920x1080 
0x12787F68, 37377931816558552, 169058455, 169058466, 11, 1920x1080 
0x12787F68, 37377931821902480, 169059000, 169059042, 42, 1920x1080 
0x12787F68, 37377931827250416, 169059546, 169059557, 11, 1920x1080 
0x12787F68, 37377931832597080, 169060078, 169060093, 15, 1920x1080 
0x12787F68, 37377931837937840, 169060596, 169060612, 16, 1920x1080 
0x12787F68, 37377931843276864, 169061134, 169061144, 10, 1920x1080 
0x12787F68, 37377931848612320, 169061693, 169061703, 10, 1920x1080 
0x12787F68, 37377931853953536, 169062216, 169062228, 12, 1920x1080 
0x12787F68, 37377931859293712, 169062727, 169062737, 10, 1920x1080 
0x12787F68, 37377931864637544, 169063276, 169063291, 15, 1920x1080 
0x12787F68, 37377931869976224, 169063795, 169063807, 12, 1920x1080 
0x12787F68, 37377931875322000, 169064341, 169064363, 22, 1920x1080 
0x12787F68, 37377931880667744, 169064907, 169064918, 11, 1920x1080 
0x12787F68, 37377931886005504, 169065401, 169065410, 9, 1920x1080 
0x12787F68, 37377931891344040, 169065939, 169065950, 11, 1920x1080 
0x12787F68, 37377931896683648, 169066470, 169066479, 9, 1920x1080 
0x12787F68, 37377931902024472, 169066994, 169067004, 10, 1920x1080 
0x12787F68, 37377931907368248, 169067530, 169067539, 9, 1920x1080 
0x12787F68, 37377931912716312, 169068117, 169068132, 15, 1920x1080 
0x12787F68, 37377931918050864, 169068605, 169068612, 7, 1920x1080 
0x12787F68, 37377931923391816, 169069156, 169069166, 10, 1920x1080 
0x12787F68, 37377931928725912, 169069692, 169069702, 10, 1920x1080 
0x12787F68, 37377931934068600, 169070203, 169070213, 10, 1920x1080 
0x12787F68, 37377931939405072, 169070759, 169070769, 10, 1920x1080 
0x12787F68, 37377931944749152, 169071299, 169071311, 12, 1920x1080 
0x12787F68, 37377931950089352, 169071843, 169071852, 9, 1920x1080 
0x12787F68, 37377931955431920, 169072356, 169072366, 10, 1920x1080 
0x12787F68, 37377931960773264, 169072920, 169072929, 9, 1920x1080 
0x12787F68, 37377931966109840, 169073422, 169073432, 10, 1920x1080 
0x12787F68, 37377931971449568, 169073981, 169073991, 10, 1920x1080 
0x12787F68, 37377931976796328, 169074510, 169074520, 10, 1920x1080 
0x12787F68, 37377931982138656, 169075041, 169075050, 9, 1920x1080 
0x12787F68, 37377931987478912, 169075579, 169075589, 10, 1920x1080 
0x12787F68, 37377931992814464, 169076107, 169076118, 11, 1920x1080 
0x12787F68, 37377931998159464, 169076639, 169076686, 47, 1920x1080 
0x12787F68, 37377932003507488, 169077175, 169077185, 10, 1920x1080 
0x12787F68, 37377932008842784, 169077711, 169077721, 10, 1920x1080 
0x12787F68, 37377932014179216, 169078232, 169078242, 10, 1920x1080 
0x12787F68, 37377932019514096, 169078791, 169078801, 10, 1920x1080 
0x12787F68, 37377932024852112, 169079293, 169079304, 11, 1920x1080 
0x12787F68, 37377932030191728, 169079857, 169079867, 10, 1920x1080 
0x12787F68, 37377932035529368, 169080359, 169080373, 14, 1920x1080 
0x12787F68, 37377932040869448, 169080895, 169080906, 11, 1920x1080 
0x12787F68, 37377932046206624, 169081452, 169081462, 10, 1920x1080 
0x12787F68, 37377932051539528, 169081964, 169081974, 10, 1920x1080 
0x12787F68, 37377932056876976, 169082490, 169082500, 10, 1920x1080 
0x12787F68, 37377932062221552, 169083027, 169083042, 15, 1920x1080 
0x12787F68, 37377932067566784, 169083592, 169083602, 10, 1920x1080 
0x12787F68, 37377932072904520, 169084109, 169084118, 9, 1920x1080 
0x12787F68, 37377932078244528, 169084629, 169084641, 12, 1920x1080 
0x12787F68, 37377932083584456, 169085162, 169085171, 9, 1920x1080 
0x12787F68, 37377932088928080, 169085717, 169085726, 9, 1920x1080 
0x12787F68, 37377932094271752, 169086229, 169086241, 12, 1920x1080 
0x12787F68, 37377932099615584, 169086760, 169086769, 9, 1920x1080 
0x12787F68, 37377932104965128, 169087301, 169087310, 9, 1920x1080 
0x12787F68, 37377932110307752, 169087856, 169087866, 10, 1920x1080 
0x12787F68, 37377932115655664, 169088385, 169088395, 10, 1920x1080 
0x12787F68, 37377932120988432, 169088904, 169088913, 9, 1920x1080 
0x12787F68, 37377932126335056, 169089432, 169089443, 11, 1920x1080 
0x12787F68, 37377932131677040, 169089998, 169090008, 10, 1920x1080 
0x12787F68, 37377932137008728, 169090541, 169090558, 17, 1920x1080 
0x12787F68, 37377932142348816, 169091064, 169091074, 10, 1920x1080 
0x12787F68, 37377932147686824, 169091583, 169091592, 9, 1920x1080 
0x12787F68, 37377932153024544, 169092140, 169092150, 10, 1920x1080 
0x12787F68, 37377932158364472, 169092638, 169092648, 10, 1920x1080 
0x12787F68, 37377932163701376, 169093198, 169093208, 10, 1920x1080 
0x12787F68, 37377932169045888, 169093715, 169093726, 11, 1920x1080 
0x12787F68, 37377932174391008, 169094264, 169094274, 10, 1920x1080 
0x12787F68, 37377932179738160, 169094805, 169094815, 10, 1920x1080 
0x12787F68, 37377932185077344, 169095303, 169095315, 12, 1920x1080 
0x12787F68, 37377932190418312, 169095842, 169095851, 9, 1920x1080 
0x12787F68, 37377932195756232, 169096384, 169096436, 52, 1920x1080 
0x12787F68, 37377932201095576, 169096927, 169096947, 20, 1920x1080 
0x12787F68, 37377932206437176, 169097446, 169097456, 10, 1920x1080 
0x12787F68, 37377932211771784, 169097998, 169098007, 9, 1920x1080 
0x12787F68, 37377932217115784, 169098527, 169098537, 10, 1920x1080 
0x12787F68, 37377932222458992, 169099042, 169099052, 10, 1920x1080 
0x12787F68, 37377932227796696, 169099577, 169099590, 13, 1920x1080 
0x12787F68, 37377932233131928, 169100124, 169100134, 10, 1920x1080 
0x12787F68, 37377932238472216, 169100653, 169100663, 10, 1920x1080 
0x12787F68, 37377932243804680, 169101189, 169101199, 10, 1920x1080 
0x12787F68, 37377932249148704, 169101714, 169101727, 13, 1920x1080 
0x12787F68, 37377932254488560, 169102254, 169102265, 11, 1920x1080 
0x12787F68, 37377932259825296, 169102787, 169102801, 14, 1920x1080 
0x12787F68, 37377932265156744, 169103317, 169103332, 15, 1920x1080 
0x12787F68, 37377932270496488, 169103877, 169103886, 9, 1920x1080 
0x12787F68, 37377932275830040, 169104403, 169104412, 9, 1920x1080 
0x12787F68, 37377932281173128, 169104950, 169104959, 9, 1920x1080 
0x12787F68, 37377932286509624, 169105456, 169105466, 10, 1920x1080 
0x12787F68, 37377932291851264, 169106009, 169106031, 22, 1920x1080 
0x12787F68, 37377932297195064, 169106517, 169106530, 13, 1920x1080 
0x12787F68, 37377932302535048, 169107068, 169107078, 10, 1920x1080 
0x12787F68, 37377932307877104, 169107584, 169107593, 9, 1920x1080 
0x12787F68, 37377932313222096, 169108146, 169108156, 10, 1920x1080 
0x12787F68, 37377932318559000, 169108663, 169108673, 10, 1920x1080 
0x12787F68, 37377932323902560, 169109207, 169109218, 11, 1920x1080 
0x12787F68, 37377932329239536, 169109758, 169109768, 10, 1920x1080 
0x12787F68, 37377932334587648, 169110260, 169110269, 9, 1920x1080 
0x12787F68, 37377932339929096, 169110812, 169110821, 9, 1920x1080 
0x12787F68, 37377932345272024, 169111319, 169111328, 9, 1920x1080 
0x12787F68, 37377932350605472, 169111874, 169111887, 13, 1920x1080 
0x12787F68, 37377932355937440, 169112421, 169112434, 13, 1920x1080 
0x12787F68, 37377932361280824, 169112961, 169112971, 10, 1920x1080 
0x12787F68, 37377932366619272, 169113492, 169113502, 10, 1920x1080 
0x12787F68, 37377932371956480, 169114023, 169114033, 10, 1920x1080 
0x12787F68, 37377932377294712, 169114548, 169114557, 9, 1920x1080 
0x12787F68, 37377932382633272, 169115065, 169115078, 13, 1920x1080 
0x12787F68, 37377932387978936, 169115610, 169115628, 18, 1920x1080 
0x12787F68, 37377932393319224, 169116147, 169116157, 10, 1920x1080 
0x12787F68, 37377932398662968, 169116663, 169116672, 9, 1920x1080 
0x12787F68, 37377932404005912, 169117203, 169117213, 10, 1920x1080 
0x12787F68, 37377932409342912, 169117744, 169117780, 36, 1920x1080 
0x12787F68, 37377932414687912, 169118277, 169118300, 23, 1920x1080 
0x12787F68, 37377932420030416, 169118814, 169118825, 11, 1920x1080 
0x12787F68, 37377932425365584, 169119331, 169119343, 12, 1920x1080 
0x12787F68, 37377932430700984, 169119861, 169119870, 9, 1920x1080 
0x12787F68, 37377932436039200, 169120425, 169120436, 11, 1920x1080 
0x12787F68, 37377932441373376, 169120941, 169120951, 10, 1920x1080 
0x12787F68, 37377932446710312, 169121463, 169121473, 10, 1920x1080 
0x12787F68, 37377932452045320, 169122025, 169122035, 10, 1920x1080 
0x12787F68, 37377932457384480, 169122543, 169122555, 12, 1920x1080 
0x12787F68, 37377932462725672, 169123079, 169123090, 11, 1920x1080 
0x12787F68, 37377932468066392, 169123636, 169123646, 10, 1920x1080 
0x12787F68, 37377932473406536, 169124160, 169124169, 9, 1920x1080 
0x12787F68, 37377932478750864, 169124702, 169124711, 9, 1920x1080 
0x12787F68, 37377932484092128, 169125204, 169125214, 10, 1920x1080 
0x12787F68, 37377932489426432, 169125755, 169125767, 12, 1920x1080 
0x12787F68, 37377932494764496, 169126289, 169126303, 14, 1920x1080 
0x12787F68, 37377932500104832, 169126811, 169126821, 10, 1920x1080 
0x12787F68, 37377932505445040, 169127337, 169127347, 10, 1920x1080 
0x12787F68, 37377932510782264, 169127892, 169127901, 9, 1920x1080 
0x12787F68, 37377932516121464, 169128412, 169128422, 10, 1920x1080 
0x12787F68, 37377932521460728, 169128962, 169128976, 14, 1920x1080 
0x12787F68, 37377932526798624, 169129477, 169129486, 9, 1920x1080 
0x12787F68, 37377932532134024, 169130019, 169130032, 13, 1920x1080 
0x12787F68, 37377932537476944, 169130546, 169130556, 10, 1920x1080 
0x12787F68, 37377932542814608, 169131102, 169131112, 10, 1920x1080 
0x12787F68, 37377932548153432, 169131614, 169131625, 11, 1920x1080 
0x12787F68, 37377932553491648, 169132176, 169132186, 10, 1920x1080 
0x12787F68, 37377932558831280, 169132678, 169132689, 11, 1920x1080 
0x12787F68, 37377932564168904, 169133250, 169133261, 11, 1920x1080 
0x12787F68, 37377932569512872, 169133769, 169133779, 10, 1920x1080 
0x12787F68, 37377932574856864, 169134281, 169134289, 8, 1920x1080 
0x12787F68, 37377932580196264, 169134833, 169134843, 10, 1920x1080 
0x12787F68, 37377932585533608, 169135372, 169135383, 11, 1920x1080 
0x12787F68, 37377932590880304, 169135912, 169135924, 12, 1920x1080 
0x12787F68, 37377932596218136, 169136422, 169136433, 11, 1920x1080 
0x12787F68, 37377932601551992, 169136959, 169136974, 15, 1920x1080 
0x12787F68, 37377932606893376, 169137491, 169137516, 25, 1920x1080 
0x12787F68, 37377932612240544, 169138023, 169138049, 26, 1920x1080 
0x12787F68, 37377932617583408, 169138558, 169138569, 11, 1920x1080 
0x12787F68, 37377932622919760, 169139111, 169139120, 9, 1920x1080 
0x12787F68, 37377932628259512, 169139653, 169139664, 11, 1920x1080 
0x12787F68, 37377932633606712, 169140186, 169140195, 9, 1920x1080 
0x12787F68, 37377932638948616, 169140724, 169140734, 10, 1920x1080 
0x12787F68, 37377932644288864, 169141258, 169141289, 31, 1920x1080 
0x12787F68, 37377932649629704, 169141785, 169141799, 14, 1920x1080 
0x12787F68, 37377932654975712, 169142320, 169142329, 9, 1920x1080 
0x12787F68, 37377932660318416, 169142850, 169142863, 13, 1920x1080 
0x12787F68, 37377932665661296, 169143386, 169143398, 12, 1920x1080 
0x12787F68, 37377932671008080, 169143906, 169143915, 9, 1920x1080 
0x12787F68, 37377932676345872, 169144469, 169144479, 10, 1920x1080 
0x12787F68, 37377932681685800, 169144988, 169144998, 10, 1920x1080 
0x12787F68, 37377932687031008, 169145509, 169145518, 9, 1920x1080 
0x12787F68, 37377932692369512, 169146054, 169146072, 18, 1920x1080 
0x12787F68, 37377932697708080, 169146590, 169146609, 19, 1920x1080 
0x12787F68, 37377932703050216, 169147130, 169147139, 9, 1920x1080 
0x12787F68, 37377932708392056, 169147658, 169147672, 14, 1920x1080 
0x12787F68, 37377932713734688, 169148197, 169148207, 10, 1920x1080 
0x12787F68, 37377932719076520, 169148743, 169148753, 10, 1920x1080 
0x12787F68, 37377932724423864, 169149252, 169149265, 13, 1920x1080 
0x12787F68, 37377932729761440, 169149776, 169149788, 12, 1920x1080 
0x12787F68, 37377932735103224, 169150310, 169150320, 10, 1920x1080 
0x12787F68, 37377932740444000, 169150845, 169150854, 9, 1920x1080 
0x12787F68, 37377932745780688, 169151378, 169151388, 10, 1920x1080 
0x12787F68, 37377932751126864, 169151917, 169151927, 10, 1920x1080 
0x12787F68, 37377932756460592, 169152457, 169152470, 13, 1920x1080 
0x12787F68, 37377932761803376, 169152982, 169152992, 10, 1920x1080 
0x12787F68, 37377932767147872, 169153552, 169153562, 10, 1920x1080 
0x12787F68, 37377932772489576, 169154074, 169154083, 9, 1920x1080 
0x12787F68, 37377932777831160, 169154583, 169154591, 8, 1920x1080 
0x12787F68, 37377932783170064, 169155137, 169155148, 11, 1920x1080 
0x12787F68, 37377932788508416, 169155668, 169155679, 11, 1920x1080 
0x12787F68, 37377932793844912, 169156224, 169156235, 11, 1920x1080 
0x12787F68, 37377932799182808, 169156731, 169156741, 10, 1920x1080 
0x12787F68, 37377932804527496, 169157274, 169157284, 10, 1920x1080 
0x12787F68, 37377932809862776, 169157789, 169157803, 14, 1920x1080 
0x12787F68, 37377932815203328, 169158323, 169158333, 10, 1920x1080 
0x12787F68, 37377932820541488, 169158875, 169158885, 10, 1920x1080 
0x12787F68, 37377932825888680, 169159403, 169159413, 10, 1920x1080 
0x12787F68, 37377932831230152, 169159948, 169159957, 9, 1920x1080 
0x12787F68, 37377932836569360, 169160479, 169160489, 10, 1920x1080 
0x12787F68, 37377932841906520, 169161020, 169161031, 11, 1920x1080 
0x12787F68, 37377932847242464, 169161538, 169161548, 10, 1920x1080 
0x12787F68, 37377932852589552, 169162076, 169162086, 10, 1920x1080 
0x12787F68, 37377932857922736, 169162588, 169162598, 10, 1920x1080 
0x12787F68, 37377932863259728, 169163134, 169163143, 9, 1920x1080 
0x12787F68, 37377932868593072, 169163677, 169163687, 10, 1920x1080 
0x12787F68, 37377932873939632, 169164208, 169164220, 12, 1920x1080 
0x12787F68, 37377932879282776, 169164724, 169164736, 12, 1920x1080 
0x12787F68, 37377932884621424, 169165258, 169165268, 10, 1920x1080 
0x12787F68, 37377932889970008, 169165795, 169165804, 9, 1920x1080 
0x12787F68, 37377932895313232, 169166335, 169166345, 10, 1920x1080 
0x12787F68, 37377932900655840, 169166871, 169166882, 11, 1920x1080 
0x12787F68, 37377932905992736, 169167428, 169167440, 12, 1920x1080 
0x12787F68, 37377932911332888, 169167930, 169167939, 9, 1920x1080 
0x12787F68, 37377932916670592, 169168467, 169168479, 12, 1920x1080 
0x12787F68, 37377932922003624, 169169030, 169169041, 11, 1920x1080 
0x12787F68, 37377932927349096, 169169564, 169169574, 10, 1920x1080 
0x12787F68, 37377932932689728, 169170084, 169170095, 11, 1920x1080 
0x12787F68, 37377932938026584, 169170621, 169170634, 13, 1920x1080 
0x12787F68, 37377932943358160, 169171154, 169171164, 10, 1920x1080 
0x12787F68, 37377932948696616, 169171699, 169171710, 11, 1920x1080 
0x12787F68, 37377932954031896, 169172235, 169172246, 11, 1920x1080 
0x12787F68, 37377932959371200, 169172732, 169172743, 11, 1920x1080 
0x12787F68, 37377932964720768, 169173296, 169173306, 10, 1920x1080 
0x12787F68, 37377932970055552, 169173831, 169173841, 10, 1920x1080 
0x12787F68, 37377932975392320, 169174333, 169174343, 10, 1920x1080 
0x12787F68, 37377932980728216, 169174873, 169174882, 9, 1920x1080 
0x12787F68, 37377932986065512, 169175409, 169175419, 10, 1920x1080 
0x12787F68, 37377932991406104, 169175952, 169175963, 11, 1920x1080 
0x12787F68, 37377932996742448, 169176508, 169176517, 9, 1920x1080 
0x12787F68, 37377933002085944, 169177000, 169177010, 10, 1920x1080 
0x12787F68, 37377933007424064, 169177553, 169177563, 10, 1920x1080 
0x12787F68, 37377933012763920, 169178083, 169178094, 11, 1920x1080 
0x12787F68, 37377933018109656, 169178605, 169178614, 9, 1920x1080 
0x12787F68, 37377933023450216, 169179147, 169179157, 10, 1920x1080 
0x12787F68, 37377933028793128, 169179712, 169179721, 9, 1920x1080 
0x12787F68, 37377933034137848, 169180233, 169180242, 9, 1920x1080 
0x12787F68, 37377933039474272, 169180770, 169180779, 9, 1920x1080 
0x12787F68, 37377933044811288, 169181282, 169181292, 10, 1920x1080 
0x12787F68, 37377933050148376, 169181827, 169181838, 11, 1920x1080 
0x12787F68, 37377933055487712, 169182347, 169182360, 13, 1920x1080 
0x12787F68, 37377933060823920, 169182876, 169182886, 10, 1920x1080 
0x12787F68, 37377933066164632, 169183417, 169183428, 11, 1920x1080 
0x12787F68, 37377933071508464, 169183973, 169183983, 10, 1920x1080 
0x12787F68, 37377933076844520, 169184502, 169184512, 10, 1920x1080 
0x12787F68, 37377933082184184, 169185027, 169185041, 14, 1920x1080 
0x12787F68, 37377933087528656, 169185569, 169185579, 10, 1920x1080 
0x12787F68, 37377933092870496, 169186099, 169186108, 9, 1920x1080 
0x12787F68, 37377933098205000, 169186625, 169186635, 10, 1920x1080 
0x12787F68, 37377933103541952, 169187165, 169187174, 9, 1920x1080 
0x12787F68, 37377933108882488, 169187695, 169187704, 9, 1920x1080 
0x12787F68, 37377933114228288, 169188214, 169188227, 13, 1920x1080 
0x12787F68, 37377933119569488, 169188760, 169188770, 10, 1920x1080 
0x12787F68, 37377933124909840, 169189286, 169189295, 9, 1920x1080 
0x12787F68, 37377933130252056, 169189836, 169189846, 10, 1920x1080 
0x12787F68, 37377933135586864, 169190349, 169190359, 10, 1920x1080 
0x12787F68, 37377933140930248, 169190895, 169190912, 17, 1920x1080 
0x12787F68, 37377933146270528, 169191429, 169191458, 29, 1920x1080 
0x12787F68, 37377933151612728, 169191959, 169191970, 11, 1920x1080 
0x12787F68, 37377933156952768, 169192504, 169192514, 10, 1920x1080 
0x12787F68, 37377933162289872, 169193045, 169193056, 11, 1920x1080 
0x12787F68, 37377933167637312, 169193579, 169193590, 11, 1920x1080 
0x12787F68, 37377933172986648, 169194112, 169194123, 11, 1920x1080 
0x12787F68, 37377933178330096, 169194638, 169194650, 12, 1920x1080 
0x12787F68, 37377933183668568, 169195195, 169195206, 11, 1920x1080 
0x12787F68, 37377933189014408, 169195723, 169195733, 10, 1920x1080 
0x12787F68, 37377933194366392, 169196265, 169196276, 11, 1920x1080 
0x12787F68, 37377933199708280, 169196797, 169196808, 11, 1920x1080 
0x12787F68, 37377933205054416, 169197307, 169197319, 12, 1920x1080 
0x12787F68, 37377933210397664, 169197863, 169197872, 9, 1920x1080 
0x12787F68, 37377933215736808, 169198372, 169198381, 9, 1920x1080 
0x12787F68, 37377933221078504, 169198933, 169198943, 10, 1920x1080 
0x12787F68, 37377933226412504, 169199462, 169199471, 9, 1920x1080 
0x12787F68, 37377933231750696, 169199986, 169199997, 11, 1920x1080 
0x12787F68, 37377933237098424, 169200548, 169200558, 10, 1920x1080 
0x12787F68, 37377933242438760, 169201046, 169201055, 9, 1920x1080 
0x12787F68, 37377933247781568, 169201592, 169201602, 10, 1920x1080 
0x12787F68, 37377933253130568, 169202119, 169202129, 10, 1920x1080 
0x12787F68, 37377933258466056, 169202659, 169202669, 10, 1920x1080 
0x12787F68, 37377933263812496, 169203186, 169203194, 8, 1920x1080 
0x12787F68, 37377933269154824, 169203720, 169203730, 10, 1920x1080 
0x12787F68, 37377933274492248, 169204247, 169204257, 10, 1920x1080 
0x12787F68, 37377933279835888, 169204803, 169204812, 9, 1920x1080 
0x12787F68, 37377933285179440, 169205320, 169205328, 8, 1920x1080 
0x12787F68, 37377933290513648, 169205884, 169205896, 12, 1920x1080 
0x12787F68, 37377933295848048, 169206385, 169206395, 10, 1920x1080 
0x12787F68, 37377933301190024, 169206921, 169206932, 11, 1920x1080 
0x12787F68, 37377933306529160, 169207453, 169207462, 9, 1920x1080 
0x12787F68, 37377933311875120, 169208000, 169208012, 12, 1920x1080 
0x12787F68, 37377933317209776, 169208525, 169208535, 10, 1920x1080 
0x12787F68, 37377933322548608, 169209052, 169209064, 12, 1920x1080 
0x12787F68, 37377933327885280, 169209584, 169209593, 9, 1920x1080 
0x12787F68, 37377933333226144, 169210122, 169210133, 11, 1920x1080 
0x12787F68, 37377933338566024, 169210663, 169210673, 10, 1920x1080 
0x12787F68, 37377933343900608, 169211193, 169211203, 10, 1920x1080 
0x12787F68, 37377933349250168, 169211723, 169211735, 12, 1920x1080 
0x12787F68, 37377933354589568, 169212277, 169212286, 9, 1920x1080 
0x12787F68, 37377933359930120, 169212788, 169212802, 14, 1920x1080 
0x12787F68, 37377933365276352, 169213322, 169213334, 12, 1920x1080 
0x12787F68, 37377933370620928, 169213868, 169213879, 11, 1920x1080 
0x12787F68, 37377933375959800, 169214393, 169214404, 11, 1920x1080 
0x12787F68, 37377933381300208, 169214940, 169214956, 16, 1920x1080 
0x12787F68, 37377933386640008, 169215480, 169215490, 10, 1920x1080 
0x12787F68, 37377933391977872, 169216018, 169216027, 9, 1920x1080 
0x12787F68, 37377933397321152, 169216555, 169216565, 10, 1920x1080 
0x12787F68, 37377933402659000, 169217060, 169217072, 12, 1920x1080 
0x12787F68, 37377933408002256, 169217596, 169217610, 14, 1920x1080 
0x12787F68, 37377933413344920, 169218132, 169218142, 10, 1920x1080 
0x12787F68, 37377933418690840, 169218674, 169218685, 11, 1920x1080 
0x12787F68, 37377933424030648, 169219208, 169219218, 10, 1920x1080 
0x12787F68, 37377933429372160, 169219732, 169219742, 10, 1920x1080 
0x12787F68, 37377933434717008, 169220278, 169220290, 12, 1920x1080 
0x12787F68, 37377933440053712, 169220811, 169220821, 10, 1920x1080 
0x12787F68, 37377933445387800, 169221337, 169221346, 9, 1920x1080 
0x12787F68, 37377933450726128, 169221870, 169221879, 9, 1920x1080 
0x12787F68, 37377933456066976, 169222409, 169222418, 9, 1920x1080 
0x12787F68, 37377933461409656, 169222937, 169222946, 9, 1920x1080 
0x12787F68, 37377933466753064, 169223483, 169223497, 14, 1920x1080 
0x12787F68, 37377933472095456, 169224011, 169224022, 11, 1920x1080 
0x12787F68, 37377933477435048, 169224548, 169224558, 10, 1920x1080 
0x12787F68, 37377933482776624, 169225071, 169225081, 10, 1920x1080 
0x12787F68, 37377933488117808, 169225621, 169225632, 11, 1920x1080 
0x12787F68, 37377933493456288, 169226168, 169226177, 9, 1920x1080 
0x12787F68, 37377933498796176, 169226696, 169226706, 10, 1920x1080 
0x12787F68, 37377933504139320, 169227220, 169227229, 9, 1920x1080 
0x12787F68, 37377933509488936, 169227759, 169227799, 40, 1920x1080 
0x12787F68, 37377933514826272, 169228285, 169228294, 9, 1920x1080 
0x12787F68, 37377933520171344, 169228853, 169228862, 9, 1920x1080 
0x12787F68, 37377933525513832, 169229367, 169229380, 13, 1920x1080 
0x12787F68, 37377933530852096, 169229906, 169229916, 10, 1920x1080 
0x12787F68, 37377933536187536, 169230428, 169230438, 10, 1920x1080 
0x12787F68, 37377933541527544, 169230955, 169230964, 9, 1920x1080 
0x12787F68, 37377933546864216, 169231496, 169231507, 11, 1920x1080 
0x12787F68, 37377933552208936, 169232045, 169232055, 10, 1920x1080 
0x12787F68, 37377933557554992, 169232583, 169232593, 10, 1920x1080 
0x12787F68, 37377933562888048, 169233104, 169233113, 9, 1920x1080 
0x12787F68, 37377933568228992, 169233642, 169233653, 11, 1920x1080 
0x12787F68, 37377933573569360, 169234166, 169234176, 10, 1920x1080 
0x12787F68, 37377933578900656, 169234694, 169234707, 13, 1920x1080 
0x12787F68, 37377933584247576, 169235259, 169235269, 10, 1920x1080 
0x12787F68, 37377933589586328, 169235763, 169235775, 12, 1920x1080 
0x12787F68, 37377933594929392, 169236299, 169236309, 10, 1920x1080 
0x12787F68, 37377933600270856, 169236846, 169236856, 10, 1920x1080 
0x12787F68, 37377933605609792, 169237366, 169237375, 9, 1920x1080 
0x12787F68, 37377933610943960, 169237902, 169237910, 8, 1920x1080 
0x12787F68, 37377933616275888, 169238446, 169238456, 10, 1920x1080 
0x12787F68, 37377933621619288, 169238968, 169238976, 8, 1920x1080 
0x12787F68, 37377933626963128, 169239519, 169239529, 10, 1920x1080 
0x12787F68, 37377933632306952, 169240052, 169240062, 10, 1920x1080 
0x12787F68, 37377933637647856, 169240566, 169240576, 10, 1920x1080 
0x12787F68, 37377933642989088, 169241103, 169241113, 10, 1920x1080 
0x12787F68, 37377933648324040, 169241666, 169241676, 10, 1920x1080 
0x12787F68, 37377933653665544, 169242169, 169242181, 12, 1920x1080 
0x12787F68, 37377933659006280, 169242730, 169242740, 10, 1920x1080 
0x12787F68, 37377933664347120, 169243241, 169243250, 9, 1920x1080 
0x12787F68, 37377933669686616, 169243799, 169243808, 9, 1920x1080 
0x12787F68, 37377933675021920, 169244311, 169244320, 9, 1920x1080 
0x12787F68, 37377933680367112, 169244844, 169244854, 10, 1920x1080 
0x12787F68, 37377933685707120, 169245373, 169245382, 9, 1920x1080 
0x12787F68, 37377933691042136, 169245906, 169245916, 10, 1920x1080 
0x12787F68, 37377933696388232, 169246449, 169246458, 9, 1920x1080 
0x12787F68, 37377933701730816, 169246981, 169246991, 10, 1920x1080 
0x12787F68, 37377933707076832, 169247537, 169247548, 11, 1920x1080 
0x12787F68, 37377933712413320, 169248061, 169248072, 11, 1920x1080 
0x12787F68, 37377933717746744, 169248574, 169248583, 9, 1920x1080 
0x12787F68, 37377933723088520, 169249131, 169249140, 9, 1920x1080 
0x12787F68, 37377933728429816, 169249644, 169249656, 12, 1920x1080 
0x12787F68, 37377933733769728, 169250198, 169250208, 10, 1920x1080 
0x12787F68, 37377933739115648, 169250735, 169250745, 10, 1920x1080 
0x12787F68, 37377933744456416, 169251268, 169251278, 10, 1920x1080 
0x12787F68, 37377933749804768, 169251807, 169251817, 10, 1920x1080 
0x12787F68, 37377933755136352, 169252313, 169252322, 9, 1920x1080 
0x12787F68, 37377933760477056, 169252848, 169252857, 9, 1920x1080 
0x12787F68, 37377933765818160, 169253399, 169253410, 11, 1920x1080 
0x12787F68, 37377933771165008, 169253918, 169253928, 10, 1920x1080 
0x12787F68, 37377933776505280, 169254451, 169254465, 14, 1920x1080 
0x12787F68, 37377933781847056, 169254981, 169254991, 10, 1920x1080 
0x12787F68, 37377933787195128, 169255515, 169255526, 11, 1920x1080 
0x12787F68, 37377933792535792, 169256049, 169256058, 9, 1920x1080 
0x12787F68, 37377933797883152, 169256610, 169256619, 9, 1920x1080 
0x12787F68, 37377933803221216, 169257120, 169257128, 8, 1920x1080 
0x12787F68, 37377933808564456, 169257691, 169257700, 9, 1920x1080 
0x12787F68, 37377933813903792, 169258217, 169258227, 10, 1920x1080 
0x12787F68, 37377933819250528, 169258748, 169258757, 9, 1920x1080 
